   E#            #P   
    #            #    
##  #  ########  #  ##
#                    #
#  ##  ##    ##  ##  #
       #      #       
       #      #       
#  ##  ########  ##  #
#                    #
##  #  ########  #  ##
    #            #    
   E#            #E   
