P ########### E
  ###########  
###############
#####     #####
#####  T  #####
#####     #####
###############
  ###########  
E ########### E
