P ########### E
  ###     ###  
#      #      #
##    ###    ##
###  #####  ###
##    ###    ##
#      #      #
  ###     ###  
E ########### E
