###################
#E               E#
#                 #
#                 #
#                 #
#                 #
#                 #
#       P         #
#                 #
#                 #
#                 #
#                 #
#                 #
#                 #
#                 #
#                 #
#                 #
#      ###        #
#      #T#        #
###################
