###################
#E               E# 
#                 # 
#                 # 
#                 # 
#                 # 
#                 # 
#       P         # 
#                 # 
#                 # 
#                 # 
#                 # 
#                 # 
#                 # 
#                 # 
#                 # 
#                 # 
#                 # 
#                 # 
###################
